000000000000000000
1    6     1  2  1
1          1     1
1          1     1
1          1     1
1          10 0001
170000000041     1
1       4  1  4  1
1   4      15   51
1          0000 01
1                1
000000000000000000