           0000000
           1  2  1
           1     1
           1     1
           1     1
           10 0001
000000000001     1
1    54    1 7   1
1          1     1
1        000000 00000000000000000000
1          1         7 1           1
1          4            4     19   1
000000000000000000000000000000000000