000000000000000000
1    6     1  2  1
1          1     1
1          1     1
1          1     1
1          10 0001
1700000000714   41
1   454    1     1
1          1  7  1
1          0000 01
15               1
000000000000000000