000000000000000000
1  4    9  1  2  1
1 4    4   1     1
1    0000001     1
1    1     1     1
1    1  4  100 001
15           4   1 
000000000001   4 1
           1  4  1
           0000 01
           15    1
           0000000