00000000000000000
1         2     1
1   000    1    1
1 4 1 1         1
1   000         1
 0     1   1   0
  1   4   4   1
   0    9    0
    100000001