000000000000000000
1 4    5    1 9  1
1           1    1
1           0004 1
1                1
1                1
1                1
1                1
1            7   1
1                1
1            2   1
000000000000000000