000000000000000000
1    6     1  2  1
1          1     1
1          1     1
1          1     1
1          10 0001
1 0000000071     1
1          1     1
1          15   51
1          0000 01
1                1
000000000000000000